XXXXXXXXXX
XS.X.....X
X.....X..X
X...T.X.GX
XXXXXXXXXX